49 49
1111111111111111111111111111111111111111111111111
1110000000000001111011100011110111100000000000011
1100000000000001110000000011100111000000000000011
1000000000000000000000000000000000000000000000001
1000000000000000000000000000000000000000000000001
1000000000000000000000000000000000000000000000001
1000000000000000000000000000000000000000000000001
1000000000000000000000001100000000000000000000001
1000000000000000000000011100000000000000000000001
1000000000000000000000011100000000000000000000001
1000000000000000000000000000000000000000000000001
1000000000000000000000000000000000000000000000001
1000000000000000000000000000000000000000000000001
1000000000000000000000000000000000000000000000001
1000000000000000000000000000000000000000000000001
1110000000000001111000000000000111100000000000011
1110000000000001111000000000000111100000000000011
1110000000000001111000000000000111100000000000011
1100000000000001110000000000000111000000000000011
1100000000000000000000000000000000000000000000001
1100000000000000000000000000000000000000000000001
1100000000000000000000000000000000000000000000001
1100000000000000000000000000000000000000000000001
1000000000000000000000000000000000000000000000001
1000000000000000000000000000000000000000000000001
1000000000000000000000000000000000000000000000001
1100000000000000000000000000000000000000000000001
1110000000000000000000000000000000000000000000001
1110000000000000000000000000000000000000000000001
1110000000000000000000000000000000000000000000001
1000000000000000000000000000000000000000000000001
1110000000000001111000000000000111100000000000011
1110000000000001111000000000000111100000000000011
1110000000000001111000000000000111100000000000011
1100000000000001110000000000000111000000000000011
1000000000000000000000000000000000000000000000001
1000000000000000000000000000000000000000000000001
1000000000000000000000000000000000000000000000001
1000000000000000000000000000000000000000000000001
1000000000000000000000000000000000000000000000001
1000000000000000000000000000000000000000000000001
1000000000000000000000000000000000000000000000001
1000000000000000000000000000000000000000000000001
1000000000000000000000000000000000000000000000001
1000000000000000000000000000000000000000000000001
1000000000000000000000000000000000000000000000001
1000000000000000000011100011100000000000000000001
1110000000000001111011110011110111100000000000011
1111111111111111111111111111111111111111111111111
